PPPPPPPPPPPPPPP
P;;;;;;;;;;;;;;
P;;;;;;;;;;;;;;
P;;;;;;;;;;;;;;
P;;;;;;;;;;;;;;
P;;;;;;;;;;;;;;
P;;;;;;;;;;;;;;
P;;;;;;;;;;;;;;
P;;;;;;;;;;;;;;
P;;;;;;;;;;;;;;
P;;;;;;;;;;;;;D
PPPPPPPPPPPPPPP
P;;;;;;;;;;;;;;
P;;;;;;;;;;;;;;
P;;;;;;;;;;;;;;
P;;;;;;;;;;;;;;
P;;;;;;;;;;;;;;
P;;;;;;;;;;;;;;
P;;;;;;;;;;;;;;
P;;;;;;;;;;;;;;
P;;;;;;;;;;;;;;
P;;;;;;;;;;;;;;
P;;;;;;;;;;;;;;
P;;;;;;;;;;;;;;
P;;;;;;;;;;;;;;
P;;;;;;;;;;;;;;
P;;;;;;;;;;;;;;
